
000000000000000000000000000000000000000000000000000000000000
000000000000000000000000000000000000000000000000000000000000
000000000000000000000000000000000000000000000000000322400000
000000000000000000000000000000000000000000000000000011000000
000000000000000000000000000000000000000000000000000000000000
000000000000000000000000000000000000000000000000000000000000
340000322222400000000000000000000000000000032222400000000034
112222111111122222222222222400000322222222211111122222222211
111111111111111111111111111122222111111111111111111111111111
111111777711111111111111111111111111177711111111111111111111
777777777777777777777777777111177777777777777777777777771111
777777777777777777777777777777777777777777777777777777777777
777777777777777777777777777777777777777777777777777777777777