000000000000000000000000000000000000000000000000000000000000
000000000000000000000000000000000000000000000000000000000000
000000000000000000000032400000032400000000000000000322400000
000000000000000034000000000000000000000000000000000011000000
000000032240000000000000000000000000000000000000000000000000
000000000000000000000000000000000000000000000000000000000000
340000000000000000000000000000000000000000032222400000000034
112222222222222222222222222400000322222222211111122222222211
111111111111111111111111111122222111111111111111111111111111
111111111111111111111111111111111111111111111111111111111111
111111111111111111111111111111111111111111111111111111111111
777777777777777777777777777777777777777777777777777777777777
777777777777777777777777777777777777777777777777777777777777